NO assets/grass.png
SO assets/grass.png
EA assets/grass.png
WE assets/grass.png



C 255,0,0
F 0,255,0

11111
10001
1N111
11111
