NO assets/grass.png
SO assets/grass.png
EA assets/grass.png
WE assets/grass.png



C 255,0,0
F 0,255,0

11111
1001       111
1N01 11  1101 
111 1      111
