NO assets/block/grass_block_snow.png
SO assets/block/grass_block_side.png
WE assets/block/mycelium_side.png
EA assets/block/podzol_side.png

F 18,255,25
C 153,204,255

        1111111111111111111111111
        1000000000110000000000001
        1011000001110000000000001
        1001000000000000000000001
111111110011000001110011110000001
1000000000110000011111    1111111
1111011111111101110001    1111
1111011111111101110101
110000001101010111000011
1000N000000000001100000011
100000000000000011010100111111
110000011101010111110111100111
11110111 1110101 101111010001
11111111 1111111 111111111111
