NO textures/wolfenstein/grey_stone.xpm
SO textures/wolfenstein/purple_stone.xpm
WE textures/wolfenstein/red_brick.xpm
EA textures/wolfenstein/wood.xpm

F 20,100,0
C 225,30,0

        1111111111111111111111111
        1N00000000110000000000001
        1011000001110000000000001
        1001000000000000000000000
111111111011000001110010110000001
1000000000110000011111    1111111
1111011111111101110001    1111
1111011111111101110101
110000001101010111000011
10000000000000001100000011
100000000000000011010100111111
110000011101010111110111100111
11110111 1110101 101111010001
11111111 1111111 111111111111
